#### Economic Crisis country tags ####
RUS = "countries/Russia.txt"
IRN = "countries/Iran.txt"
IND = "countries/India.txt"
UZB = "countries/Uzbekistan.txt"
TJK = "countries/Tadjikistan.txt"
TKM = "countries/Turkmenistan.txt"
KGZ = "countries/Kyrgyzstan.txt"
MDA = "countries/Moldovia.txt"
SCO = "countries/Scotland.txt"
WAL = "countries/Wales.txt"
KAR = "countries/Kareliya.txt"
PRK = "countries/North Korea.txt"
GAN = "countries/Gana.txt"
NIG = "countries/Nigeria.txt"
MAR = "countries/Marekash.txt"
SOM = "countries/Somali.txt"
ERT = "countries/Eritreya.txt"
DJB = "countries/Djibuti.txt"
GEQ = "countries/Ekv_Gvinea.txt"
NAM = "countries/Namibiya.txt"
MAD = "countries/Madacascar.txt"
KUV = "countries/Kuveyt.txt"
UAE = "countries/UAE.txt"
KPR = "countries/Kepr.txt"
TNZ = "countries/Tanzania.txt"
UGA = "countries/Uganda.txt"
TUN = "countries/Tunis.txt"
ALG = "countries/Algeria.txt"
SEN = "countries/Senegal.txt"
SUD = "countries/Sudan.txt"
SVN = "countries/Slovenia.txt"
BIH = "countries/Bosnia.txt"
MNE = "countries/Chernogoria.txt"
MKD = "countries/Macedonia.txt"
MTN = "countries/Mavretania.txt"
GUI = "countries/Gvinea.txt"
GBS = "countries/Gvinea_Bisau.txt"
CIV = "countries/Kotduvar.txt"
TOG = "countries/Togo.txt"
BEN = "countries/Benin.txt"
BUR = "countries/Burkina-Faso.txt"
MLI = "countries/Mali.txt"
NGR = "countries/Niger.txt"
CHA = "countries/Chad.txt"
CMR = "countries/Camerun.txt"
SWZ = "countries/Svazilend.txt"
LES = "countries/Lesoto.txt"
MAW = "countries/Malavi.txt"
GAB = "countries/Gabon.txt"
CAF = "countries/Centr_Africa.txt"
COD = "countries/Congo_democratic.txt"
ZAM = "countries/Zambiya.txt"
RUA = "countries/Ruanda.txt"
BRD = "countries/Burundi.txt"
SLE = "countries/Sera-Leone.txt"
GAM = "countries/Gambia.txt"
WSA = "countries/W.Sahara.txt"
BLZ = "countries/Beliz.txt"
JAM = "countries/Jamaica.txt"
BGL = "countries/Bangladesh.txt"
MYN = "countries/Myanma.txt"
SIN = "countries/Singapur.txt"
TAI = "countries/Taivan.txt"
PNG = "countries/PNG.txt"
SHR = "countries/Shri-Lanka.txt"
KAT = "countries/Katar.txt"
GAY = "countries/Gayana.txt"
SUR = "countries/Surinam.txt"
BRU = "countries/Bruney.txt"
FJI = "countries/Fiji.txt"
SOI = "countries/Solomon_Islands.txt"
IGL = "countries/ISIS.txt"
CRM = "countries/Crimea.txt"
NRU = "countries/N.Russia.txt"
ABZ = "countries/Abxazia.txt"
SOS = "countries/S.Osetia.txt"
BHR = "countries/Bahrain.txt"
SEY = "countries/Seyshel.txt"
MRI = "countries/Mavrikiy.txt"
COM = "countries/Comor.txt"
STP = "countries/Sant-Tome.txt"
CPV = "countries/Capo-Verde.txt"
TRI = "countries/Trinidad.txt"
PLW = "countries/Palau.txt"
MHI = "countries/Marshal.txt"
MDV = "countries/Maldiv.txt"
LIE = "countries/Lixtenshteyn.txt"
MNC = "countries/Monaco.txt"
SMR = "countries/San-Marino.txt"
BGM = "countries/Bagami.txt"
GRN = "countries/Grenada.txt"
BRB = "countries/Barbados.txt"
VTS = "countries/Sent-Vitsen.txt"
LCA = "countries/Sent-Lyusiya.txt"
ANT = "countries/Antigua-Barbuda.txt"
DMA = "countries/Dominicana.txt"
NAU = "countries/Nauru.txt"
FSM = "countries/Mikronezia.txt"
TUV = "countries/Tuvalu.txt"
KIR = "countries/Kribati.txt"
TLS = "countries/E.Timor.txt"
SSD = "countries/S.Sudan.txt"
KOS = "countries/Kosovo.txt"
NKR = "countries/NKR.txt"
TMD = "countries/Transnistria.txt"
DNR = "countries/DNR.txt"
LNR = "countries/LNR.txt"
SSR = "countries/Opozitsion_Syria.txt"
KUR = "countries/Kurdistan.txt"
VAT = "countries/Vatican.txt"
MLT = "countries/Malta.txt"
NCY = "countries/North Cyprus.txt"
ALQ = "countries/Al_Qaeda.txt"
TAL = "countries/Taliban.txt"
AND = "countries/Andorra.txt"
DAG = "countries/Dagestan.txt"
CHE = "countries/Chechnia.txt"
ING = "countries/Ingushtia.txt"
BLD = "countries/Beludjistan.txt"
VAZ = "countries/Vaziristan.txt"
CAT = "countries/Cataloniya.txt"
GAL = "countries/Galisiya.txt"
TEX = "countries/Texas.txt"
CZR = "countries/Czechia.txt"
ROC = "countries/China Republic.txt"
UYG = "countries/Uyghuristan.txt"
HKG = "countries/Hong Kong.txt"
MAC = "countries/Macau.txt"
PUE = "countries/Puerto-Rico.txt"
SML = "countries/Somalilend.txt"
IG1 = "countries/ISIS_Libya.txt"
IG2 = "countries/ISIS_Nigeria.txt"
IG3 = "countries/ISIS_Afghanistan.txt"
EUR = "countries/European_Union.txt"
ROJ = "countries/Rojava.txt"

BAS = "countries/Basque_Country.txt"
KRC = "countries/Karachay-Cherkessia.txt"
TAT = "countries/Tatarstan.txt"
KHA = "countries/Khalistan.txt"
NAG = "countries/Nagaland.txt"
ASM = "countries/Assam.txt"
GOR = "countries/Gorkhaland.txt"
BOD = "countries/Bodoland.txt"
PSH = "countries/Pashtunistan.txt"
SND = "countries/Sindh.txt"